8
16
0120001111111111
2301111000020000
0120000033333333
0100203330111000
0110333000111200
0010302200111120
2010302220111111
0010322200001111
