8
16
3000001101111111
3300000111111111
0001111133333333
3011113332222222
3011333222222222
3311322222222222
3311322222222222
3311322222222222
